
            XXXXXXX     
            XXXXXXX     
            XXXXXXX     
            XXXXXXXX    
            XXXXXXXX    
            XXXXXXXXXXXX
            XXXXXXXXXXXX
            XXXXXXXXXXXX
             XXXXXXXXXXX
             XXXXXXXXXXX
             XXXXXXXXXXX
             XXXXXXXXXXX
             XXXXXXXXXXX
             XXXXXXXXXXX
             XXXXXXXXXX 
             XXXXXXXXX  
             XXXXXXXX   
             XXXXXXX    
             XXXXXXX    
            XXXXXXXX    
          XXXXXXXXXX    
         XXXXXXXXXXX    
         XXXXXXXXXX     
         XXXXXXXXX      
         XXXXXXXX       
         XXXXXXXX       
         XXXXXXXX       
         XXXXXXXX       
         XXXXXXX        
         XXXXXXX        
        XXXXXXXX        
        XXXXXXXX        
        XXXXXXXX        
        XXXXXXXX        
       XXXXXXXXX        
      XXXXXXXXXX        
     XXXXXXXXXXX        
     XXXXXXXXXX         
     XXXXXXXX           
     XXXXXXX            
     XXXXXXX            
     XXXXXXX            
     XXXXXXXX           
     XXXXXXXXX          
     XXXXXXXXXX         
     XXXXXXXXXXX        
     XXXXXXXXXXXX       
   XXXXXXXXXXXXXXX      
XXXXXXXXXXXXXXXXXX      
XXXXXXXXXXXXXXXXXX      
XXXXXXXXXXXXXXXXXX      
XXXXXXXXXXXXXXXXXX      
XXXXXXXXXXXXXXXXXX      
XXXXXXXXXXXXXXXXXX      
XXXXXXXX                